2 13 31
###############################
#p  *  ** *  1 *   *  * *     #
# # # #*# # #*#*# # # # #*# # #
#  **     ***  *  1   *     * #
# # # # # #*# # #*#*# # # # #*#
#f  *      x **  *  *   3     #
# # # # # # # # # #*# #*# # # #
#*  *   *  *  *    2          #
# # # # #*# # # #*# # # # # # #
#*    *  *     3 *            #
# #*# # # # # # #*# # # # # # #
#    *      *   *  *          #
###############################